###########################
##....#####################
###########################
##.......................##
##.......................##
##.......................##
##.......................##
##.......................##
##.......................##
##.......................##
###########################