#########..#########
#..................#
#...#####..........#
#...#...#..........#
#...#..#........#...
#...####........#...
#...#..#........####
#...#...#..........#
#...#####..........#
####################