####################
#...##..........#..#
#...##..@.......#..#
#...##..........L..#
#...######..........
#....W..............
#.L.......L....L...#
#...######.........#
#..................#
#######..###########