####################
#..................#
#.........#........#
#........#.#.......#
........#...#.......
.......#######......
#.....#.......#....#
#....#.........#...#
#..................#
#######...##########