######..############
#..................#
#...###########....#
#...#..............#
....#..............#
....#..............#
#...#..............#
#...###########....#
#..................#
#######..###########