####################
#..................#
#..................#
#.............LL...#
..............LL...#
..............LL...#
#...........L..W####
#...........LLLL####
#..................#
####################